.............................................................
.............................................................
.............................................................
.............................................................
.............................................................
.............................................................
.....WWWWWWWWWWWWWWWWW.WWWWWWWWWWWW..........................
.....W...............W............W..........................
.....W...............W............W..........................
.....W...............W............W..........................
.....W...............W............W..........................
.....W...............W............W..........................
.....W...............W............W..........................
.....W...............W............W..........................
.....W...............W............W..........................
.....WWWWWWWWWWWWWWW.W............W..........................
.....W............................W..........................
.....W.................WWWWWWWWWWWWWWWWWWWWWWWWWWWW..........
.....W............................W...............W..........
.....W............................W...............W..........
.....W............................W...............W..........
.....W........WWWW................W...............W..........
.....W........WWWW................W...............W..........
.....W........WWWW................................W..........
.....W........WWWW................W...............W..........
.....W........WWWW................W...............W..........
.....W........WWWW................W...............W..........
.....W........WWWW................W...............W..........
.....W........WWWW................WWWWWWWWWWWWWWWWW..........
.....W........WWWW................W..........................
.....W........WWWW................W..........................
.....W........WWWW................W..........................
.....W........WWWW................W..........................
.....W........WWWW................W..........................
.....W........WWWW................W..........................
.....W........WWWW................W..........................
.....WWWWWWWWWWWWWWWWWWWWWWWWWWWWWW..........................
.............................................................
.............................................................
.............................................................
.............................................................
.............................................................
.............................................................
.............................................................
.............................................................
.............................................................
.............................................................
.............................................................
.............................................................
.............................................................
.............................................................
.............................................................
.............................................................
.............................................................
.............................................................
.............................................................
.............................................................
.............................................................
.............................................................
.............................................................
.............................................................