DebugMap 2 61 60
. # _ . . . . . . . . . . . . . . . . . . . . . . . . . . . . . . . . . . . . . . . . . . . . . . . . . . . . . . . . . .
. . . . . . . . . . . . . . . . . . . . . . . . . . . . . . . . . . . . . . . . . . . . . . . . . . . . . . . . . . . . .
. . . . . . . . . . . . . . . . . . . . . . . . . . . . . . . . . . . . . . . . . . . . . . . . . . . . . . . . . . . . .
. . . . . . . . . . . . . . . . . . . . . . . . . . . . . . . . . . . . . . . . . . . . . . . . . . . . . . . . . . . . .
. . . . . . . . . . . . . . . . . . . . . . . . . . . . . . . . . . . . . . . . . . . . . . . . . . . . . . . . . . . . .
. . . . . . . . . . . . . . . . . . . . . . . . . . . . . . . . . . . . . . . . . . . . . . . . . . . . . . . . . . . . .
. . . . . # # # # # # # # # # # # # # # # # _ # # # # # # # # # # # # . . . . . . . . . . . . . . # . . . . . . . . . . .
. . . . . # _ _ _ _ _ _ _ _ _ _ _ _ _ _ _ # _ _ _ _ _ _ _ _ _ _ _ _ # . . . . . . . . . . . . . . . . . . . . . . . . . .
. . . . . # _ _ _ _ _ _ _ _ _ _ _ _ _ _ _ # _ _ _ _ _ _ _ _ _ _ _ _ # . . . . . . . . . . . . . . . . . . . . . . . . . .
. . . . . # _ _ _ _ _ _ _ _ _ _ _ _ _ _ _ # _ _ _ _ _ _ _ _ _ _ _ _ # . . . . . . . . . . . . . . . . . . . . . . . . . .
. . . . . # _ _ _ _ _ _ _ _ _ _ _ _ _ _ _ # _ _ _ _ _ _ _ _ _ _ _ _ # . . . . . . . . . . . . . . . . . . . . . . . . . .
. . . . . # _ _ _ _ _ _ _ _ _ _ _ _ _ _ _ # _ _ _ _ _ _ _ _ _ _ _ _ # . . . . . . . . . . . . . . . . . . . . . . . . . .
. . . . . # _ _ _ _ _ _ _ _ _ _ _ _ _ _ _ # _ _ _ _ _ _ _ _ _ _ _ _ # . . . . . . . . . . . . . . . . . . . . . . . . . .
. . . . . # _ _ _ _ _ _ _ _ _ _ _ _ _ _ _ # _ _ _ _ _ _ _ _ _ _ _ _ # . . . . . . . . . . . . . . . . . . . . . . . . . .
. . . . . # _ _ _ _ _ _ _ _ _ _ _ _ _ _ _ # _ _ _ _ _ _ _ _ _ _ _ _ # . . . . . . . . . . . . . . . . . . . . . . . . . .
. . . . . # # # # # # _ # _ # # # # # # _ # _ _ _ _ _ _ _ _ _ _ _ _ # . . . . . . . . . . . . . . . . . . . . . . . . . .
. . . . . # _ _ _ _ _ _ _ _ _ _ _ _ _ _ _ _ _ _ _ _ _ _ _ _ _ _ _ _ # . . . . . . . . . . . . . . . . . . . . . . . . . .
. . . . . # _ _ _ _ _ _ _ _ _ _ _ _ _ _ _ _ _ # # # # # # # # # # # # # # # # # # # _ _ # # # # # # # . . . . . . . . . .
. . . . . # _ _ _ _ _ _ _ _ _ _ # _ _ _ _ _ _ _ _ _ _ _ _ _ _ _ _ _ # _ _ _ _ _ _ _ _ _ _ _ _ _ _ _ # . . . . . . . . . .
. . . . . # _ _ _ _ _ _ _ _ _ _ _ _ _ _ _ _ _ _ _ _ _ _ _ _ _ _ _ _ # _ _ _ _ _ _ _ _ _ _ _ _ _ _ _ # . . . . . . . . . .
. . . . . # _ _ _ _ _ _ _ _ _ _ _ _ _ _ _ _ _ _ _ _ _ _ _ _ _ _ _ _ # _ _ _ _ _ _ _ _ _ _ _ _ _ _ _ # . . . . . . . . . .
. . . . . # _ _ _ _ _ _ _ _ # _ _ # _ _ _ _ _ _ _ _ _ _ _ _ _ _ _ _ # _ _ _ _ _ _ _ _ _ _ _ _ _ _ _ # . . . . . . . . . .
. . . . . # _ _ _ _ _ _ _ _ # . . # _ _ _ _ _ _ _ _ _ _ _ _ _ _ _ _ # _ # # # # # # _ _ # # # # # _ # . . . . . . . . . .
. . . . . # _ _ _ _ _ _ _ _ # . . # _ _ _ _ _ _ _ _ _ _ _ _ _ _ _ _ _ _ _ _ _ _ _ _ _ _ _ _ _ _ _ _ _ . . . . . . . . . .
. . . . . # _ _ _ _ _ _ _ _ # . . # _ _ _ _ _ _ _ _ _ _ _ _ _ _ _ _ # _ # # # # # # _ _ # # # # # _ # . . . . . . . . . .
. . . . . # _ _ _ _ _ _ _ _ # . . # _ _ _ _ _ # # # _ _ _ _ _ _ _ _ # _ _ _ _ _ _ _ _ _ _ _ _ _ _ _ # . . . . . . . . . .
. . . . . # _ _ _ _ _ _ _ _ # . . # _ _ _ _ _ _ _ _ _ _ _ _ _ _ _ _ # _ _ _ _ _ _ _ _ _ _ _ _ _ _ _ # . . . . . . . . . .
. . . . . # _ _ _ _ _ _ _ _ # . . # _ _ _ _ _ _ _ _ _ _ _ _ _ _ _ _ # _ _ _ _ _ _ _ _ _ _ _ _ _ _ _ # . . . . . . . . . .
. . . . . # _ _ _ _ _ _ _ _ # . . # _ _ _ _ _ # _ # _ _ _ _ _ _ _ _ # # # # # # # # # # # # # # # # # . . . . . . . . . .
. . . . . # _ _ _ _ _ _ _ _ # . . # _ _ _ _ _ # _ # _ _ _ _ _ _ _ _ # . . . . . . . . . . . . . . . . . . . . . . . . . .
. . . . . # _ _ _ _ _ _ _ _ # . . # _ _ _ _ _ # _ # _ _ _ _ _ _ _ _ # . . . . . . . . . . . . . . . . . . . . . . . . . .
. . . . . # _ _ _ _ _ _ _ _ # . . # _ _ _ _ _ # _ # _ _ _ _ _ _ _ _ # . . . . . . . . . . . . . . . . . . . . . . . . . .
. . . . . # _ _ _ _ _ _ _ _ # . . # _ _ _ _ _ _ _ _ _ _ _ _ _ _ _ _ # . . . . . . . . . . . . . . . . . . . . . . . . . .
. . . . . # _ _ _ _ _ _ _ _ # . . # _ _ _ _ _ _ _ _ _ _ _ _ _ _ _ _ # . . . . . . . . . . . . . . . . . . . . . . . . . .
. . . . . # _ _ _ _ _ _ _ _ # . . # _ _ _ _ _ _ _ _ _ _ _ _ _ _ _ _ # . . . . . . . . . . . . . . . . . . . . . . . . . .
. . . . . # _ _ _ _ _ _ _ _ # . . # _ _ _ _ _ _ _ _ _ _ _ _ _ _ _ _ # . . . . . . . . . . . . . . . . . . . . . . . . . .
. . . . . # # # # # # # # # # . . # # # # # # # # # # # # # # # # # # . . . . . . . . . . . . . . . . . . . . . . . . . .
. . . . . . . . . . . . . . . . . . . . . . . . . . . . . . . . . . . . . . . . . . . . . . . . . . . . . . . . . . . . .
. . . . . . . . . . . . . . . . . . . . . . . . . . . . . . . . . . . . . . . . . . . . . . . . . . . . . . . . . . . . .
. . . . . . . . . . . . . . . . . . . . . . . . . . . . . . . . . . . . . . . . . . . . . . . . . . . . . . . . . . . . .
. . . . . . . . . . . . . . . . . . . . . . . . . . . . . . . . . . . . . . . . . . . . . . . . . . . . . . . . . . . . .
. . . . . . . . . . . . . . . . . . . . . . . . . . . . . . . . . . . . . . . . . . . . . . . . . . . . . . . . . . . . .
. . . . . . . . . . . . . . . . . . . . . . . . . . . . . . . . . . . . . . . . . . . . . . . . . . . . . . . . . . . . .
. . . . . . . . . . . . . . . . . . . . . . . . . . . . . . . . . . . . . . . . . . . . . . . . . . . . . . . . . . . . .
. . . . . . . . . . . . . . . . . . . . . . . . . . . . . . . . . . . . . . . . . . . . . . . . . . . . . . . . . . . . .
. . . . . . . . . . . . . . . . . . . . . . . . . . . . . . . . . . . . . . . . . . . . . . . . . . . . . . . . . . . . .
. . . . . . . . . . . . . . . . . . . . . . . . . . . . . . . . . . . . . . . . . . . . . . . . . . . . . . . . . . . . .
. . . . . . . . . . . . . . . . . . . . . . . . . . . . . . . . . . . . . . . . . . . . . . . . . . . . . . . . . . . . .
. . . . . . . . . . . . . . . . . . . . . . . . . . . . . . . . . . . . . . . . . . . . . . . . . . . . . . . . . . . . .
. . . . . . . . . . . . . . . . . . . . . . . . . . . . . . . . . . . . . . . . . . . . . . . . . . . . . . . . . . . . .
. . . . . . . . . . . . . . . . . . . . . . . . . . . . . . . . . . . . . . . . . . . . . . . . . . . . . . . . . . . . .
. . . . . . . . . . . . . . . . . . . . . . . . . . . . . . . . . . . . . . . . . . . . . . . . . . . . . . . . . . . . .
. . . . . . . . . . . . . . . . . . . . . . . . . . . . . . . . . . . . . . . . . . . . . . . . . . . . . . . . . . . . .
. . . . . . . . . . . . . . . . . . . . . . . . . . . . . . . . . . . . . . . . . . . . . . . . . . . . . . . . . . . . .
. . . . . . . . . . . . . . . . . . . . . . . . . . . . . . . . . . . . . . . . . . . . . . . . . . . . . . . . . . . . .
. . . . . . . . . . . . . . . . . . . . . . . . . . . . . . . . . . . . . . . . . . . . . . . . . . . . . . . . . . . . .
. . . . . . . . . . . . . . . . . . . . . . . . . . . . . . . . . . . . . . . . . . . . . . . . . . . . . . . . . . . . .
. . . . . . . . . . . . . . . . . . . . . . . . . . . . . . . . . . . . . . . . . . . . . . . . . . . . . . . . . . . . .
. . . . . . . . . . . . . . . . . . . . . . . . . . . . . . . . . . . . . . . . . . . . . . . . . . . . . . . . . . . . .
. . . . . . . . . . . . . . . . . . . . . . . . . . . . . . . . . . . . . . . . . . . . . . . . . . . . . . . . . . . . .
# # # . . . . . . . . . . . . . . . . . . . . . . . . . . . . . . . . . . . . . . . . . . . . . . . . . . . . . . . . . .
. . . . . . . . . . . . . . . . . . . . . . . . . . . . . . . . . . . . . . . . . . . . . . . . . . . . . . . . . . . . .
. . . . . . . . . . . . . . . . . . . . . . . . . . . . . . . . . . . . . . . . . . . . . . . . . . . . . . . . . . . . .
. . . . . . . . . . . . . . . . . . . . . . . . . . . . . . . . . . . . . . . . . . . . . . . . . . . . . . . . . . . . .
. . . . . . . . . . . . . . . . . . . . . . . . . . . . . . . . . . . . . . . . . . . . . . . . . . . . . . . . . . . . .
. . . . . . . . . . . . . . . . . . . . . . . . . . . . . . . . . . . . . . . . . . . . . . . . . . . . . . . . . . . . .
. . . . . # # # # # # # # # # # # # # # # # _ # # # # # # # # # # # # . . . . . . . . . . . . . . # . . . . . . . . . . .
. . . . . # _ _ _ _ _ _ _ _ _ _ _ _ _ _ _ # _ _ _ _ _ _ _ _ _ _ _ _ # . . . . . . . . . . . . . . . . . . . . . . . . . .
. . . . . # _ _ _ _ _ _ _ _ _ _ _ _ _ _ _ # _ _ _ _ _ _ _ _ _ _ _ _ # . . . . . . . . . . . . . . . . . . . . . . . . . .
. . . . . # _ _ _ _ _ _ _ _ _ _ _ _ _ _ _ # _ _ _ _ _ _ _ _ _ _ _ _ # . . . . . . . . . . . . . . . . . . . . . . . . . .
. . . . . # _ _ _ _ _ _ _ _ _ _ _ _ _ _ _ # _ _ _ _ _ _ _ _ _ _ _ _ # . . . . . . . . . . . . . . . . . . . . . . . . . .
. . . . . # _ _ _ _ _ _ _ _ _ _ _ _ _ _ _ # _ _ _ _ _ _ _ _ _ _ _ _ # . . . . . . . . . . . . . . . . . . . . . . . . . .
. . . . . # _ _ _ _ _ _ _ _ _ _ _ _ _ _ _ # _ _ _ _ _ _ _ _ _ _ _ _ # . . . . . . . . . . . . . . . . . . . . . . . . . .
. . . . . # _ _ _ _ _ _ _ _ _ _ _ _ _ _ _ # _ _ _ _ _ _ _ _ _ _ _ _ # . . . . . . . . . . . . . . . . . . . . . . . . . .
. . . . . # _ _ _ _ _ _ _ _ _ _ _ _ _ _ _ # _ _ _ _ _ _ _ _ _ _ _ _ # . . . . . . . . . . . . . . . . . . . . . . . . . .
. . . . . # # # # # # _ # _ # # # # # # _ # _ _ _ _ _ _ _ _ _ _ _ _ # . . . . . . . . . . . . . . . . . . . . . . . . . .
. . . . . # _ _ _ _ _ _ _ _ _ _ _ _ _ _ _ _ _ _ _ _ _ _ _ _ _ _ _ _ # . . . . . . . . . . . . . . . . . . . . . . . . . .
. . . . . # _ _ _ _ _ _ _ _ _ _ _ _ _ _ _ _ _ # # # # # # # # # # # # # # # # # # # _ _ # # # # # # # . . . . . . . . . .
. . . . . # _ _ _ _ _ _ _ _ _ _ # _ _ _ _ _ _ _ _ _ _ _ _ _ _ _ _ _ # _ _ _ _ _ _ _ _ _ _ _ _ _ _ _ # . . . . . . . . . .
. . . . . # _ _ _ _ _ _ _ _ _ _ _ _ _ _ _ _ _ _ _ _ _ _ _ _ _ _ _ _ # _ _ _ _ _ _ _ _ _ _ _ _ _ _ _ # . . . . . . . . . .
. . . . . # _ _ _ _ _ _ _ _ _ _ _ _ _ _ _ _ _ _ _ _ _ _ _ _ _ _ _ _ # _ _ _ _ _ _ _ _ _ _ _ _ _ _ _ # . . . . . . . . . .
. . . . . # _ _ _ _ _ _ _ _ # _ _ # _ _ _ _ _ _ _ _ _ _ _ _ _ _ _ _ # _ _ _ _ _ _ _ _ _ _ _ _ _ _ _ # . . . . . . . . . .
. . . . . # _ _ _ _ _ _ _ _ # . . # _ _ _ _ _ _ _ _ _ _ _ _ _ _ _ _ # _ # # # # # # _ _ # # # # # _ # . . . . . . . . . .
. . . . . # _ _ _ _ _ _ _ _ # . . # _ _ _ _ _ _ _ _ _ _ _ _ _ _ _ _ _ _ _ _ _ _ _ _ _ _ _ _ _ _ _ _ _ . . . . . . . . . .
. . . . . # _ _ _ _ _ _ _ _ # . . # _ _ _ _ _ _ _ _ _ _ _ _ _ _ _ _ # _ # # # # # # _ _ # # # # # _ # . . . . . . . . . .
. . . . . # _ _ _ _ _ _ _ _ # . . # _ _ _ _ _ # # # _ _ _ _ _ _ _ _ # _ _ _ _ _ _ _ _ _ _ _ _ _ _ _ # . . . . . . . . . .
. . . . . # _ _ _ _ _ _ _ _ # . . # _ _ _ _ _ _ _ _ _ _ _ _ _ _ _ _ # _ _ _ _ _ _ _ _ _ _ _ _ _ _ _ # . . . . . . . . . .
. . . . . # _ _ _ _ _ _ _ _ # . . # _ _ _ _ _ _ _ _ _ _ _ _ _ _ _ _ # _ _ _ _ _ _ _ _ _ _ _ _ _ _ _ # . . . . . . . . . .
. . . . . # _ _ _ _ _ _ _ _ # . . # _ _ _ _ _ # _ # _ _ _ _ _ _ _ _ # # # # # # # # # # # # # # # # # . . . . . . . . . .
. . . . . # _ _ _ _ _ _ _ _ # . . # _ _ _ _ _ # _ # _ _ _ _ _ _ _ _ # . . . . . . . . . . . . . . . . . . . . . . . . . .
. . . . . # _ _ _ _ _ _ _ _ # . . # _ _ _ _ _ # _ # _ _ _ _ _ _ _ _ # . . . . . . . . . . . . . . . . . . . . . . . . . .
. . . . . # _ _ _ _ _ _ _ _ # . . # _ _ _ _ _ # _ # _ _ _ _ _ _ _ _ # . . . . . . . . . . . . . . . . . . . . . . . . . .
. . . . . # _ _ _ _ _ _ _ _ # . . # _ _ _ _ _ _ _ _ _ _ _ _ _ _ _ _ # . . . . . . . . . . . . . . . . . . . . . . . . . .
. . . . . # _ _ _ _ _ _ _ _ # . . # _ _ _ _ _ _ _ _ _ _ _ _ _ _ _ _ # . . . . . . . . . . . . . . . . . . . . . . . . . .
. . . . . # _ _ _ _ _ _ _ _ # . . # _ _ _ _ _ _ _ _ _ _ _ _ _ _ _ _ # . . . . . . . . . . . . . . . . . . . . . . . . . .
. . . . . # _ _ _ _ _ _ _ _ # . . # _ _ _ _ _ _ _ _ _ _ _ _ _ _ _ _ # . . . . . . . . . . . . . . . . . . . . . . . . . .
. . . . . # # # # # # # # # # . . # # # # # # # # # # # # # # # # # # . . . . . . . . . . . . . . . . . . . . . . . . . .
. . . . . . . . . . . . . . . . . . . . . . . . . . . . . . . . . . . . . . . . . . . . . . . . . . . . . . . . . . . . .
. . . . . . . . . . . . . . . . . . . . . . . . . . . . . . . . . . . . . . . . . . . . . . . . . . . . . . . . . . . . .
. . . . . . . . . . . . . . . . . . . . . . . . . . . . . . . . . . . . . . . . . . . . . . . . . . . . . . . . . . . . .
. . . . . . . . . . . . . . . . . . . . . . . . . . . . . . . . . . . . . . . . . . . . . . . . . . . . . . . . . . . . .
. . . . . . . . . . . . . . . . . . . . . . . . . . . . . . . . . . . . . . . . . . . . . . . . . . . . . . . . . . . . .
. . . . . . . . . . . . . . . . . . . . . . . . . . . . . . . . . . . . . . . . . . . . . . . . . . . . . . . . . . . . .
. . . . . . . . . . . . . . . . . . . . . . . . . . . . . . . . . . . . . . . . . . . . . . . . . . . . . . . . . . . . .
. . . . . . . . . . . . . . . . . . . . . . . . . . . . . . . . . . . . . . . . . . . . . . . . . . . . . . . . . . . . .
. . . . . . . . . . . . . . . . . . . . . . . . . . . . . . . . . . . . . . . . . . . . . . . . . . . . . . . . . . . . .
. . . . . . . . . . . . . . . . . . . . . . . . . . . . . . . . . . . . . . . . . . . . . . . . . . . . . . . . . . . . .
. . . . . . . . . . . . . . . . . . . . . . . . . . . . . . . . . . . . . . . . . . . . . . . . . . . . . . . . . . . . .
. . . . . . . . . . . . . . . . . . . . . . . . . . . . . . . . . . . . . . . . . . . . . . . . . . . . . . . . . . . . .
. . . . . . . . . . . . . . . . . . . . . . . . . . . . . . . . . . . . . . . . . . . . . . . . . . . . . . . . . . . . .
. . . . . . . . . . . . . . . . . . . . . . . . . . . . . . . . . . . . . . . . . . . . . . . . . . . . . . . . . . . . .
. . . . . . . . . . . . . . . . . . . . . . . . . . . . . . . . . . . . . . . . . . . . . . . . . . . . . . . . . . . . .
. . . . . . . . . . . . . . . . . . . . . . . . . . . . . . . . . . . . . . . . . . . . . . . . . . . . . . . . . . . . .
. . . . . . . . . . . . . . . . . . . . . . . . . . . . . . . . . . . . . . . . . . . . . . . . . . . . . . . . . . . . .
. . . . . . . . . . . . . . . . . . . . . . . . . . . . . . . . . . . . . . . . . . . . . . . . . . . . . . . . . . . . .
. . . . . . . . . . . . . . . . . . . . . . . . . . . . . . . . . . . . . . . . . . . . . . . . . . . . . . . . . . . . .
. . . . . . . . . . . . . . . . . . . . . . . . . . . . . . . . . . . . . . . . . . . . . . . . . . . . . . . . . . . . .
. . . . . . . . . . . . . . . . . . . . . . . . . . . . . . . . . . . . . . . . . . . . . . . . . . . . . . . . . . . . .
. . . . . . . . . . . . . . . . . . . . . . . . . . . . . . . . . . . . . . . . . . . . . . . . . . . . . . . . . . . . .
. . . . . . . . . . . . . . . . . . . . . . . . . . . . . . . . . . . . . . . . . . . . . . . . . . . . . . . . . . . . .